3 1 0 1 3
1 2 1 2 1
4 1 2 1 4
1 2 1 2 1
3 1 0 1 3
